##########
#...@....#
#.########
#.########
#........#
########.#
#........#
#.########
#........#
##########